Что такое API для нас: строки
concat(): объединение строк
valueOf(): преобразует Object в строковое представление (завязан на toString())
join(): объединяет набор строк в одну с учетом разделителя
charAt(): получение символа по индексу
indexOf(): первый индекс вхождения подстроки
lastIndexOf(): последний индекс вхождения подстроки
startsWith()/endsWith(): определяет, начинается/
replace(): замена одной подстроки на другую
trim(): удаляет начальные и конечные пробелы
substring(): возвращает подстроку, см.аргументы
toLowerCase()/toUpperCase(): возвращает новую строку в нижнем/верхнем регистре
сompareTo(): сравнивает две строки
equals(): сравнивает строки с учетом регистра
equalsIgnoreCase(): сравнивает строки без учета регистра
regionMatches(): сравнивает подстроки в строках


Много изменений – String
Много преобразований – StringBuilder


Работа с файловой системой

isHidden(): возвращает истину, если каталог или файл является скрытым
length(): возвращает размер файла в байтах
lastModified(): возвращает время последнего изменения файла или каталога
list(): возвращает массив файлов и подкаталогов, которые находятся в каталоге
listFiles(): возвращает массив файлов и подкаталогов, которые находятся в определенном каталоге
mkdir(): создает новый каталог
renameTo(File dest): переименовывает файл или каталог

Логирование. Использование. Основы

Использование
Logger logger = Logger.getLogger()
Уровни важности
INFO, DEBUG, ERROR, WARNING и др.
Вывод
ConsoleHandler info = new ConsoleHandler();
log.addHandler(info);
Формат вывода: структурированный, абы как*
XMLFormatter, SimpleFormatter

